1111111111111888811111111111111118888888111188888888888811111111111111111111111
1111111111111888811111111111111118888888111188888888888811111111111111111111111
1111111111111888811111111111111118888888111188888888888811111111111111111111111
1111111111111888811111111111111118888888111188888888888811111111111111111111111
8888888888888888888888888888888888888888111188888888888888888888888888888888888
8888888888888888888888888888888888888888111188888888888888888888888888888888888
8888888888888888888888888888888888888888111188888888888888888888888888888888888
8888888888888888888888888888888888888888111188888888888888888888888888888888888
8888888888888888888888888888888888888888111188888888888888888888888888888888888
8888888888888888888888888888888111188888111188888888888888888888888888888888888
8888888888888888888888888888888111188888888888881188888881111888888888888888888
8888888888888888888888888888888111188888888888881188888881111888888888888888888
8888888888888888888888888888888111188888888888881188888881111888888888888888888
8888888888888888888888888888888111188888888888111188888881111888888888888888888
8888888888888888881111111188888111188888888888111188888881111888888888888888888
8888888888888888881111111188888111188888888888111188888881111888888888888888888
8888888888811888881111111188888111188888888888111188888881111888888888888888888
8888888888811888881111111188888111188888888888111188888881111888888888888888888
8888888888111888881111111188888111188888881111111188888881111888888888888888888
8888888881111888881111111188888111188888881111111188888881111888888888888888888
8888888111111888881111111188888111188888881111111188888881111888888888888888888
8888881111111888881111111188888111188888881111111188888881111888888888888888888
8888111111111888881111111188888111188888881111111188888881111888888888888888888
8888111111111888881111111188888111188888881111111188888881111888888888888888888
1111111111111888881111111188888111188888881111111188888881111888888811111111111